11111111
1P001CE1
10C01101
10000001
1V011101
1C010001
10010C01
11111111