11111111
1P0010E1
10CC1101
10C00001
1V011101
1C010001
10010C01
11111111