1111111111
1P001EV111
10C0110111
10000001C1
1001110111
1C01000111
10010C0111
1111111111